The Magic Kitchen
An Interactive Fiction by Savleen and Daddy
Release 1 / Serial number 221030 / Inform 7 v10.1.2 / D

Kitchen
The kitchen has new white marble tiles but is not yet finished.

You can see some stories, a magic bottle, some blue chalk, a stool, Simi and Savleen here.

Welcome
An interactive campaign
Release 1 / Serial number 221027 / Inform 7 v10.1.2 / D

Lessons

>ono
That's not a verb I recognise.

>to
That's not a verb I recognise.

>eat
(yourself)
You're plainly inedible.

>x
What do you want to examine?

>x me
As good-looking as ever.

>one two
That's not a verb I recognise.

* * *

The Magic Kitchen
An Interactive Fiction by Savleen and Daddy
Release 1 / Serial number 221030 / Inform 7 v10.1.2 / D

Kitchen
The kitchen has new white marble tiles but is not yet finished.

You can see some stories, a magic bottle, some blue chalk, a stool, Simi and Savleen here.

>x Simi
Simi is a cute little baby girl. She is holding a bottle of milky.

>take milky
That seems to belong to Simi.

* * *

The Magic Kitchen
An Interactive Fiction by Savleen and Daddy
Release 1 / Serial number 221030 / Inform 7 v10.1.2 / D

Kitchen
The kitchen has new white marble tiles but is not yet finished.

You can see some stories, a magic bottle, some blue chalk, a stool, Simi and Savleen here.

>eat savleen
She's plainly inedible.

>eat simi
You can't eat baby Simi!!!!

>why not?
That's not a verb I recognise.

* * *

>eat savleen
She's plainly inedible.

>take savleen
I don't suppose Savleen would care for that.

>make a cake
That's not a verb I recognise.

* * *

The Magic Kitchen
An Interactive Fiction by Savleen and Daddy
Release 1 / Serial number 221030 / Inform 7 v10.1.2 / D

Kitchen
The kitchen has new white marble tiles but is not yet finished.

You can see some stories, a magic bottle, some blue chalk, a stool, Simi and Savleen here.

>eat simi
You can't eat baby Simi!!!!

>eat chalk
They're plainly inedible.

>eat bottlo
You can't see any such thing.

>eat magic
That's plainly inedible.

>look at simi
Simi is a cute little baby girl. She is holding a bottle of milkyi.

* * *

>eat simi
You can't eat baby Simi!!!!

>eat savleen
She's plainly inedible.

>x chalk
If you rub it on something, the something turns light blue.

>n
Hallway

>n
Girl's Room

>s
Hallway

>e
Bathroom

>w
Hallway

>s
Kitchen
The kitchen has new white marble tiles but is not yet finished.

You can see some stories, a magic bottle, some blue chalk, a stool, Simi and Savleen here.

>go outside
Patio

>inside
Kitchen
The kitchen has new white marble tiles but is not yet finished.

You can see some stories, a magic bottle, some blue chalk, a stool, Simi and Savleen here.

>x simi
Simi is a cute little baby girl. She is holding a bottle of milky.

>take milky
That seems to belong to Simi.

* * *

>eat simi
You can't eat baby Simi!!!!

>talk to her
That's not a verb I recognise.

>ask her
I'm not sure what 'her' refers to.

* * *

>eat simi
You can't eat baby Simi!!!!

>x simi
Simi is a cute little baby girl. She is holding a bottle of milky.

>l simi
Simi is a cute little baby girl. She is holding a bottle of milky.

>talk simi
That's not a verb I recognise.

>talk to simi
That's not a verb I recognise.

>ask simi
What do you want to ask Simi for?

>ask simi for miltky
You can't see any such thing.

>ask simi for milky
Simi has better things to do.

* * *

The Magic Kitchen
An Interactive Fiction by Savleen and Daddy
Release 1 / Serial number 221030 / Inform 7 v10.1.2 / D

Kitchen
The kitchen has new white marble tiles but is not yet finished.

You can see some stories, a magic bottle, some blue chalk, a stool, Simi and Savleen here.

>l
Kitchen
It has new white marble tiles but is not yet finished.

You can see some stories, a magic bottle, some blue chalk, a stool and Simi here.

>n
Hallway

>l
Hallway

>s
Kitchen
It has new white marble tiles but is not yet finished.

You can see some stories, a magic bottle, some blue chalk, a stool and Simi here.

>time
That's not a verb I recognise.

>eat simi
He's plainly inedible.

* * *

The Magic Kitchen
An Interactive Fiction by Savleen and Daddy
Release 1 / Serial number 221030 / Inform 7 v10.1.2 / D

Kitchen
The kitchen has new white marble tiles but is not yet finished.

You can see some stories, a magic bottle, some blue chalk, a stool, Simi and Savleen here.

>l exits
You can't see any such thing.

>exits
That's not a verb I recognise.

>take all
stories: Taken.
magic bottle: Taken.
blue chalk: Taken.
stool: Taken.
milky: That seems to belong to Simi.

>x simi
Simi is a cute little baby girl. She is holding a bottle of milky.

>x milky
You see nothing special about the milky.

* * *

The Magic Kitchen
An Interactive Fiction by Savleen and Daddy
Release 1 / Serial number 221030 / Inform 7 v10.1.2 / D

Kitchen
The kitchen has new white marble tiles but is not yet finished.

You can see some stories, a magic bottle, some blue chalk, a stool, Simi and Savleen here.

>make a cake
That's not a verb I recognise.

* * *

The Magic Kitchen
An Interactive Fiction by Savleen and Daddy
Release 1 / Serial number 221030 / Inform 7 v10.1.2 / D

Kitchen
The kitchen has new white marble tiles but is not yet finished.

You can see some stories, a magic bottle, some blue chalk, a stool, Simi and Savleen here.

>replay
That's not a verb I recognise.

* * *

The Magic Kitchen
An Interactive Fiction by Savleen and Daddy
Release 1 / Serial number 221030 / Inform 7 v10.1.2 / D

Kitchen
The kitchen has new white marble tiles but is not yet finished.

You can see some stories, a magic bottle, some blue chalk, a stool, Simi and Savleen here.

>test
>--> The following tests are available:
'test me'

>test me
(Testing.)

>[1] z
[Your score has just gone up by five points.]

Tempus fugit.>[2] z
[Your score has just gone up by five points.]

>[3] z
[Your score has just gone up by five points.]

>[4] jump

    *** The End ***

In that game you scored 15 out of a possible 0, in 4 turns.

Would you like to RESTART, RESTORE a saved game, QUIT or UNDO the last command?

* * *

The Magic Kitchen
An Interactive Fiction by Savleen and Daddy
Release 1 / Serial number 221030 / Inform 7 v10.1.2 / D

Kitchen
The kitchen has new white marble tiles but is not yet finished.

You can see some stories, a magic bottle, some blue chalk, a stool, Simi and Savleen here.

>test me
>--> No test scripts exist for this game.

* * *

The Magic Kitchen
An Interactive Fiction by Savleen and Daddy
Release 1 / Serial number 221030 / Inform 7 v10.1.2 / D

Kitchen
The kitchen has new white marble tiles but is not yet finished.

You can see some stories, a magic bottle, some blue chalk, a stool, Simi and Savleen here.

>x her
I'm not sure what 'her' refers to.

>l simi
Simi is a cute little baby girl. She is holding a bottle of milky.

>x her
I'm not sure what 'her' refers to.

* * *

The Magic Kitchen
An Interactive Fiction by Savleen and Daddy
Release 1 / Serial number 221030 / Inform 7 v10.1.2 / D

Kitchen
The kitchen has new white marble tiles but is not yet finished.

You can see some stories, a magic bottle, some blue chalk, a stool, Simi and Savleen here.

>x stool
It has fallen over.

>x bottle
It is magical because of its colors.

>take bottle
Taken.

>i
You are carrying:
  a magic bottle

>eat simi
He's plainly inedible.