2008
An Interactive Fiction by michal
Release 1 / Serial number 080311 / Inform 7 build 5J39 (I6/v6.31 lib 6/11N) SD

bedroom
It is a nice room.

You can see a weight bench, an elliptical machine, a piano (on which are an iBook and some sheet music) and a bed here.

>north
Stairs

>south
office

>south
kitchen

>n
office

>e
You can't go that way.

>w
hallway

>w
hall closet

>l
hall closet

>e
hallway

>n
bathroom

>s
hallway

>s
bedroom

>n
hallway

>e
office

>n
Stairs

>d
entryway

>e
parking lot

>n
trash

>d
You can't go that way.

>s
parking lot

>s
mailbox

>s
You can't go that way.

* * *

2008
An Interactive Fiction by michal
Release 1 / Serial number 080311 / Inform 7 build 5J39 (I6/v6.31 lib 6/11N) SD

bedroom
It is a nice room.

You can see a weight bench, an elliptical machine, a piano (on which are an iBook and some sheet music) and a bed here.

>l
bedroom

>where am i
That's not a verb I recognise.

>who am i
That's not a verb I recognise.

I beg your pardon?

I beg your pardon?

* * *

2008
An Interactive Fiction by michal
Release 1 / Serial number 080311 / Inform 7 build 5J39 (I6/v6.31 lib 6/11N) SD

bedroom
It is a nice room.

You can see a weight bench, an elliptical machine, a piano (on which are an iBook and some sheet music) and a bed here.

>lift weights
That's not a verb I recognise.

* * *

2008
An Interactive Fiction by michal
Release 1 / Serial number 080311 / Inform 7 build 5J39 (I6/v6.31 lib 6/11N) SD

bedroom
It is a nice room.

You can see a weight bench, an elliptical machine, a piano (on which are an iBook and some sheet music) and a bed here.

>look piano
I only understood you as far as wanting to look.

>x piano
It is a 82-key electronic MIDI keyboard from casio.

>x weight bench
You see nothing special about the weight bench.

* * *

2008
An Interactive Fiction by michal
Release 1 / Serial number 080311 / Inform 7 build 5J39 (I6/v6.31 lib 6/11N) SD

bedroom
It is a nice room.

You can see a weight bench, an elliptical machine, a piano (on which are an iBook and some sheet music) and a bed here.

>look sheet music
I only understood you as far as wanting to look.

>x sheet music
You see nothing special about the sheet music.

>x bed
You see nothing special about the bed.

>south
You can't go that way.

>x room
You can't see any such thing.

>x bedroom
You can't see any such thing.